name;pkt size;trial number;tx packets;rx packets;dropped packets;duration(ms)
len-1-noveth;64;1;141867904;4516372;137351532;10000
len-1-noveth;128;1;82213552;5790818;76422734;10000
len-1-noveth;256;1;44576512;5721507;38855005;10000
len-1-noveth;512;1;23297024;5504803;17792221;10000
len-1-noveth;1024;1;11910656;5381954;6528702;10000
len-1-noveth;1280;1;9573696;5335300;4238396;10000
len-1-noveth;1462;1;8401088;5295486;3105602;10000
len-1-veth;64;1;142004416;7406840;134597576;10000
len-1-veth;128;1;82166016;4354785;77811231;10000
len-1-veth;256;1;44561984;4325634;40236350;10000
len-1-veth;512;1;23291200;4367550;18923650;10000
len-1-veth;1024;1;11910720;6257766;5652954;10000
len-1-veth;1280;1;9572736;4176135;5396601;10000
len-1-veth;1462;1;8399808;4170829;4228979;10000
len-2-noveth;64;1;142009408;1312472;140696936;10000
len-2-noveth;128;1;82154368;1568213;80586155;10000
len-2-noveth;256;1;44517376;1650511;42866865;10000
len-2-noveth;512;1;23299712;1329947;21969765;10000
len-2-noveth;1024;1;11912448;1311220;10601228;10000
len-2-noveth;1280;1;9574400;1352195;8222205;10000
len-2-noveth;1462;1;8402240;1354560;7047680;10000
len-2-veth;64;1;141966272;1449867;140516405;10000
len-2-veth;128;1;82146048;2314836;79831212;10000
len-2-veth;256;1;44585856;2341564;42244292;10000
len-2-veth;512;1;23307520;2223896;21083624;10000
len-2-veth;1024;1;11916672;2168879;9747793;10000
len-2-veth;1280;1;9578496;2154953;7423543;10000
len-2-veth;1462;1;8401856;2175875;6225981;10000
len-3-noveth;64;1;141985792;715507;141270285;10000
len-3-noveth;128;1;82134400;620704;81513696;10000
len-3-noveth;256;1;44585472;699532;43885940;10000
len-3-noveth;512;1;23304512;698790;22605722;10000
len-3-noveth;1024;1;11915712;682059;11233653;10000
len-3-noveth;1280;1;9577344;678292;8899052;10000
len-3-noveth;1462;1;8404544;674933;7729611;10000
len-3-veth;64;1;141939776;1093212;140846564;10000
len-3-veth;128;1;82222400;814477;81407923;10000
len-3-veth;256;1;44550080;801629;43748451;10000
len-3-veth;512;1;23291904;788309;22503595;10000
len-3-veth;1024;1;11910976;779096;11131880;10000
len-3-veth;1280;1;9574848;775901;8798947;10000
len-3-veth;1462;1;8398208;775162;7623046;10000
len-4-noveth;64;1;141778368;273485;141504883;10000
len-4-noveth;128;1;82239360;328524;81910836;10000
len-4-noveth;256;1;44585728;327616;44258112;10000
len-4-noveth;512;1;23304448;317856;22986592;10000
len-4-noveth;1024;1;11915520;315764;11599756;10000
len-4-noveth;1280;1;9577152;318123;9259029;10000
len-4-noveth;1462;1;8404352;317900;8086452;10000
len-4-veth;64;1;141954048;496348;141457700;10000
len-4-veth;128;1;82223488;396441;81827047;10000
len-4-veth;256;1;44576704;392188;44184516;10000
len-4-veth;512;1;23299648;383625;22916023;10000
len-4-veth;1024;1;11912256;378813;11533443;10000
len-4-veth;1280;1;9574592;377009;9197583;10000
len-4-veth;1462;1;8402240;376009;8026231;10000
len-5-noveth;64;1;142005568;127002;141878566;10000
len-5-noveth;128;1;82122240;112588;82009652;10000
len-5-noveth;256;1;44584256;126423;44457833;10000
len-5-noveth;512;1;23303872;119088;23184784;10000
len-5-noveth;1024;1;11914240;122475;11791765;10000
len-5-noveth;1280;1;9575936;123755;9452181;10000
len-5-noveth;1462;1;8403584;121481;8282103;10000
len-5-veth;64;1;141901952;301216;141600736;10000
len-5-veth;128;1;82079040;281952;81797088;10000
len-5-veth;256;1;44590720;256997;44333723;10000
len-5-veth;512;1;23307328;248613;23058715;10000
len-5-veth;1024;1;11916160;245110;11671050;10000
len-5-veth;1280;1;9577472;243350;9334122;10000
len-5-veth;1462;1;8403648;243625;8160023;10000
len-6-noveth;64;1;141933056;86928;141846128;10000
len-6-noveth;128;1;82131776;58141;82073635;10000
len-6-noveth;256;1;44584896;65616;44519280;10000
len-6-noveth;512;1;23304000;62677;23241323;10000
len-6-noveth;1024;1;11914304;63988;11850316;10000
len-6-noveth;1280;1;9576064;64357;9511707;10000
len-6-noveth;1462;1;8403520;62131;8341389;10000
len-6-veth;64;1;142014336;118534;141895802;10000
len-6-veth;128;1;82143872;112381;82031491;10000
len-6-veth;256;1;44499520;120744;44378776;10000
len-6-veth;512;1;23296960;101660;23195300;10000
len-6-veth;1024;1;11912256;116457;11795799;10000
len-6-veth;1280;1;9577472;108555;9468917;10000
len-6-veth;1462;1;8404032;108270;8295762;10000
len-7-noveth;64;1;141873088;30136;141842952;10000
len-7-noveth;128;1;82085760;31318;82054442;10000
len-7-noveth;256;1;44583488;17942;44565546;10000
len-7-noveth;512;1;23304000;29524;23274476;10000
len-7-noveth;1024;1;11914496;23153;11891343;10000
len-7-noveth;1280;1;9575872;26005;9549867;10000
len-7-noveth;1462;1;8403712;23942;8379770;10000
len-7-veth;64;1;142007552;34197;141973355;10000
len-7-veth;128;1;82138112;35893;82102219;10000
len-7-veth;256;1;44546944;35549;44511395;10000
len-7-veth;512;1;23293248;37780;23255468;10000
len-7-veth;1024;1;11913088;43875;11869213;10000
len-7-veth;1280;1;9577024;44119;9532905;10000
len-7-veth;1462;1;8403584;43871;8359713;10000
len-8-noveth;64;1;142003048;3235;141999813;10000
len-8-noveth;128;1;82239224;7447;82231777;10000
len-8-noveth;256;1;44585408;9888;44575520;10000
len-8-noveth;512;1;23303936;9594;23294342;10000
len-8-noveth;1024;1;11914176;8156;11906020;10000
len-8-noveth;1280;1;9576320;9445;9566875;10000
len-8-noveth;1462;1;8403776;10245;8393531;10000
len-8-veth;64;1;141985408;21240;141964168;10000
len-8-veth;128;1;82214080;14598;82199482;10000
len-8-veth;256;1;44572672;14462;44558210;10000
len-8-veth;512;1;23298624;14120;23284504;10000
len-8-veth;1024;1;11912000;13959;11898041;10000
len-8-veth;1280;1;9574336;13860;9560476;10000
len-8-veth;1462;1;8401984;13818;8388166;10000
len-9-noveth;64;1;141929728;4181;141925547;10000
len-9-noveth;128;1;82233152;4107;82229045;10000
len-9-noveth;256;1;44582464;3539;44578925;10000
len-9-noveth;512;1;23302784;4191;23298593;10000
len-9-noveth;1024;1;11915264;3583;11911681;10000
len-9-noveth;1280;1;9576448;4130;9572318;10000
len-9-noveth;1462;1;8403712;3990;8399722;10000
len-9-veth;64;1;141940224;19564;141920660;10000
len-9-veth;128;1;82124928;11660;82113268;10000
len-9-veth;256;1;44544064;11562;44532502;10000
len-9-veth;512;1;23290560;11341;23279219;10000
len-9-veth;1024;1;11911168;13173;11897995;10000
len-9-veth;1280;1;9573952;11171;9562781;10000
len-9-veth;1462;1;8397632;11140;8386492;10000
len-10-noveth;64;1;141820480;2426;141818054;10000
len-10-noveth;128;1;82236416;2012;82234404;10000
len-10-noveth;256;1;44583488;3350;44580138;10000
len-10-noveth;512;1;23303424;1425;23301999;10000
len-10-noveth;1024;1;11914176;2273;11911903;10000
len-10-noveth;1280;1;9575936;2514;9573422;10000
len-10-noveth;1462;1;8403520;2843;8400677;10000
len-10-veth;64;1;141813120;12597;141800523;10000
len-10-veth;128;1;82139008;7778;82131230;10000
len-10-veth;256;1;44549696;7716;44541980;10000
len-10-veth;512;1;23293760;7673;23286087;10000
len-10-veth;1024;1;11913152;8867;11904285;10000
len-10-veth;1280;1;9577408;9245;9568163;10000
len-10-veth;1462;1;8403968;9167;8394801;10000
baseline;64;1;141967616;11166100;130801516;10000
baseline;128;1;82202168;13016097;69186071;10000
baseline;256;1;44574208;13016098;31558110;10000
baseline;512;1;23294016;12991555;10302461;10000
baseline;1024;1;11906560;10992589;913971;10000
baseline;1280;1;9570560;9570561;-1;10000
baseline;1462;1;8398592;8398469;123;10000
